###@#
#k#.#
#.#.#
#...#
#####

#@###.
#aaa##
###..#
#k..##
#####.

##@##
#...#
#rrr#
#.k.#
#####

##@##
#.ra#
#k.##
####.

#@####
#...4#
#.k.##
#4.r#.
##..#.
.####.

##@##
#4r.#
#..a#
#.ak#
#####

##@###
#sf..#
##k###
.###..

.#@#..
.#i#..
##c###
#f..k#
###.##
..###.

##@##
#fs.#
#ki.#
#f..#
#####

##@#..
#fa###
#.ir.#
##.fk#
.#####

#@#######
#f##...f#
#s.....k#
#####i.##
....####.
